000001110000011100000
000112111101111111100
000111111101111131100
000111111111111111100
011111111111111111110
011111111112111111110
001111111111111111100
001111111111111111100
000111113111111111000
000111111111111111000
000011111111111110000
000001111111111100000
000000111111111000000
000000011111110000000
000000001131100000000
000000000111000000000
000000000010000000000
